1111111111111111111111111111111111111111111
10111111000000000000000000E0000000000000001
1010010110010000H101001000000010101C00000C1
10100100110101010001001000000010101C00000C1
101001001011010100P1001000000010101C00000C1
10100100101101010001001000000010101C00000C1
10100100101011010001001000000010101C00000C1
1010011000000010101C00000C00000000000000001
1010010010101010101C00000C00000000000000001
1010010010101011000100100000000000000000001
1010010010101010001001000000010101C00000C01
10100100101010101001001000000010101C00000C1
10100100101010100101001000000010101C00000C1
10100100101010100011001000000010101C00000C1
10100100101010100011001000000010101C00000C1
10100100101010100010101000000010101C00000C1
10100100101010100010011000000010101C00000C1
100000000C00C00000000010000000000C1C0000001
1111111111111111111111111111111111111111111