11111111111111111111111
1E000000H00000C000000E1
101001010010000H0000011
10100100100100010010101
1P00000C0000000000000C1
11111111111111111111111