11111111
10E11111
1CP11111
10P11111
11111111