
11111111111111111111

111111C001100H111111
11111000000001111111
11110A00000011111111
11P000C0E01111111111
11111111111111111111
11111111111111111111
11111111111111111111